5
10
OOOOOOOOOO
OSSSOSSSSO
OSOOSSOOSO
OMSSSKSSSO
OOOOOOOOOO
